name,tag,iteration_start,iteration_end,batch_size,prompt_tasks_in_batch,memory,pending_requests,pending_tasks,blocked_tasks,pending_prompts,earliest_request_id,memory_allocs_size,num_contiguous_iterations,batch_tokens,pending_tokens
None_149,token,12.776660156250045,92.77666015625005,1,0,161030899200.0,3,2,0,0,15673,4,8.0,1,2
None_149,token,92.77666015625005,122.77666015625005,3,0,164252648960.0,4,1,0,0,15673,5,3.0,3,1
None_149,token,122.77666015625005,142.77666015625005,4,0,169836316160.0,5,1,0,0,15673,6,2.0,4,1
None_149,token,142.77666015625005,162.77666015625005,5,0,175296775680.0,6,1,0,0,15673,7,2.0,5,1
None_149,token,162.77666015625005,192.77666015625005,6,0,183716840960.0,8,2,0,0,15673,9,3.0,6,2
None_149,token,192.77666015625005,242.77666015625005,8,0,187284620800.0,9,1,0,0,15673,10,5.0,8,1
None_149,token,242.77666015625005,272.77666015625005,9,0,189444687360.0,10,1,0,0,15673,11,3.0,9,1
None_149,token,272.77666015625005,282.77666015625005,10,0,192766051840.0,11,1,0,0,15673,12,1.0,10,1
None_149,token,282.77666015625005,302.77666015625005,11,0,194409694720.0,12,1,0,0,15673,13,2.0,11,1
None_149,token,302.77666015625005,312.77666015625005,12,0,196037608960.0,13,1,0,0,15673,14,1.0,12,1
None_149,token,312.77666015625005,322.77666015625005,13,0,199479559680.0,14,1,0,0,15673,15,1.0,13,1
None_149,token,322.77666015625005,352.77666015625005,14,0,203393369600.0,15,1,0,0,15673,16,3.0,14,1
None_149,token,352.77666015625005,372.77666015625005,15,0,207301936640.0,16,1,0,0,15673,17,2.0,15,1
None_149,token,372.77666015625005,392.77666015625005,16,0,211367790080.0,17,1,0,0,15673,18,2.0,16,1
None_149,token,392.77666015625005,412.77666015625005,17,0,213942044160.0,18,1,0,0,15673,19,2.0,17,1
None_149,token,412.77666015625005,432.77666015625005,18,0,215449372160.0,19,1,0,0,15673,20,2.0,18,1
None_149,token,432.77666015625005,442.77666015625005,19,0,216290854400.0,20,1,0,0,15673,21,1.0,19,1
None_149,token,442.77666015625005,452.77666015625005,20,0,219478525440.0,21,1,0,0,15673,22,1.0,20,1
None_149,token,452.77666015625005,472.77666015625005,21,0,224789562880.0,22,1,0,0,15673,23,2.0,21,1
None_149,token,472.77666015625005,502.77666015625005,22,0,227701982720.0,23,1,0,0,15673,24,3.0,22,1
None_149,token,502.77666015625005,532.77666015625,23,0,232048330240.0,24,1,0,0,15673,25,3.0,23,1
None_149,token,532.77666015625,552.77666015625,24,0,235954275840.0,25,1,0,0,15673,26,2.0,24,1
None_149,token,552.77666015625,582.77666015625,25,0,243873646080.0,26,1,0,0,15673,27,3.0,25,1
None_149,token,582.77666015625,632.77666015625,26,0,246466250240.0,27,1,0,0,15673,28,5.0,26,1
None_149,token,632.77666015625,662.77666015625,27,0,249858393600.0,28,1,0,0,15673,29,3.0,27,1
None_149,token,662.77666015625,682.77666015625,28,0,251271349760.0,29,1,0,0,15673,30,2.0,28,1
None_149,token,682.77666015625,692.77666015625,28,0,248123000320.0,35,7,0,0,16089,36,1.0,28,7
None_149,token,692.77666015625,702.77666015625,35,0,259680929280.0,36,1,0,0,16089,37,1.0,35,1
None_149,token,702.77666015625,762.77666015625,36,0,260283860480.0,37,1,0,0,16089,38,6.0,36,1
None_149,token,762.77666015625,772.77666015625,37,0,263426967040.0,38,1,0,0,16089,39,1.0,37,1
None_149,token,772.77666015625,802.77666015625,38,0,267558356480.0,39,1,0,0,16089,40,3.0,38,1
None_149,token,802.77666015625,962.77666015625,39,0,269034227200.0,39,0,0,0,16089,40,16.0,39,0
None_149,token,962.77666015625,992.77666015625,38,0,264061355520.0,39,1,0,0,16089,40,3.0,38,1
None_149,token,992.77666015625,1002.77666015625,39,0,267794286080.0,40,1,0,0,16089,41,1.0,39,1
None_149,token,1002.77666015625,1012.77666015625,39,0,269865223680.0,42,3,0,0,16089,43,1.0,39,3
None_149,token,1012.77666015625,1052.77666015625,42,0,272413263360.0,43,1,0,0,16089,44,4.0,42,1
None_149,token,1052.77666015625,1062.77666015625,43,0,275443648000.0,44,1,0,0,16089,45,1.0,43,1
None_149,token,1062.77666015625,1072.77666015625,44,0,276741260800.0,44,0,0,0,16089,45,1.0,44,0
None_149,token,1072.77666015625,1082.77666015625,43,0,276272023040.0,44,1,0,0,16089,45,1.0,43,1
None_149,token,1082.77666015625,1092.77666015625,43,0,275294225920.0,47,4,0,0,16089,48,1.0,43,4
None_149,token,1092.77666015625,1102.77666015625,47,0,277698086400.0,48,1,0,0,16089,49,1.0,47,1
None_149,token,1102.77666015625,1122.77666015625,48,0,281163630080.0,49,1,0,0,16089,50,2.0,48,1
None_149,token,1122.77666015625,1142.77666015625,49,0,285171811840.0,50,1,0,0,16089,51,2.0,49,1
None_149,token,1142.77666015625,1162.77666015625,49,0,287612372480.0,50,1,0,0,16320,51,2.0,49,1
None_149,token,1162.77666015625,1182.77666015625,50,0,291942991360.0,51,1,0,0,16320,52,2.0,50,1
None_149,token,1182.77666015625,1192.77666015625,50,0,289895646720.0,53,3,0,0,16320,54,1.0,50,3
None_149,token,1192.77666015625,1202.77666015625,53,0,294831818240.0,54,1,0,0,16320,55,1.0,53,1
None_149,token,1202.77666015625,1232.77666015625,54,0,299010393600.0,55,1,0,0,16320,56,3.0,54,1
None_149,token,1232.77666015625,1242.77666015625,55,0,305951966720.0,56,1,0,0,16320,57,1.0,55,1
None_149,token,1242.77666015625,1292.77666015625,56,0,308956136960.0,57,1,0,0,16320,58,5.0,56,1
None_149,token,1292.77666015625,1312.77666015625,57,0,311960307200.0,58,1,0,0,16320,59,2.0,57,1
None_149,token,1312.77666015625,1332.77666015625,58,0,315001177600.0,59,1,0,0,16320,60,2.0,58,1
None_149,token,1332.77666015625,1352.77666015625,59,0,317095708160.0,60,1,0,0,16320,61,2.0,59,1
None_149,token,1352.77666015625,1362.77666015625,60,0,318382835200.0,61,1,0,0,16320,62,1.0,60,1
None_149,token,1362.77666015625,1382.77666015625,61,0,322065958400.0,62,1,0,0,16320,63,2.0,61,1
None_149,token,1382.77666015625,1392.77666015625,61,0,320535037440.0,62,1,0,0,16320,63,1.0,61,1
None_149,token,1392.77666015625,1402.77666015625,62,0,325025564160.0,63,1,0,0,16320,64,1.0,62,1
None_149,token,1402.77666015625,1412.77666015625,62,0,324561569280.0,65,3,0,0,16320,66,1.0,62,3
None_149,token,1412.77666015625,1422.77666015625,65,0,325846074880.0,65,0,0,0,16320,66,1.0,65,0
None_149,token,1422.77666015625,1432.77666015625,64,0,326758336000.0,66,2,0,0,16320,67,1.0,64,2
None_149,token,1432.77666015625,1452.77666015625,66,0,329982707200.0,67,1,0,0,16320,68,2.0,66,1
None_149,token,1452.77666015625,1462.77666015625,67,0,333322421760.0,68,1,0,0,16320,69,1.0,67,1
None_149,token,1462.77666015625,1492.77666015625,68,0,337262446080.0,69,1,0,0,16320,70,3.0,68,1
None_149,token,1492.77666015625,1522.77666015625,69,0,341370242560.0,70,1,0,0,16320,71,3.0,69,1
None_149,token,1522.77666015625,1542.77666015625,70,0,353156236800.0,71,1,0,0,16320,72,2.0,70,1
None_149,token,1542.77666015625,1562.77666015625,71,0,353625474560.0,71,0,0,0,16320,72,2.0,71,0
None_149,token,1562.77666015625,1582.77666015625,70,0,350878205440.0,70,0,0,0,16320,71,2.0,70,0
None_149,token,1582.77666015625,1592.77666015625,68,0,358247073280.0,69,1,0,0,16320,70,1.0,68,1
None_149,token,1592.77666015625,1602.77666015625,69,0,358506595840.0,69,0,0,0,16320,70,1.0,69,0
None_149,token,1602.77666015625,1642.77666015625,68,0,360176453120.0,69,1,0,0,16320,70,4.0,68,1
None_149,token,1642.77666015625,1672.77666015625,69,0,364585715200.0,71,2,0,0,16320,72,3.0,69,2
None_149,token,1672.77666015625,1692.77666015625,71,0,365836142080.0,71,0,0,0,16320,72,2.0,71,0
None_149,token,1692.77666015625,1702.77666015625,70,0,367403763200.0,71,1,0,0,16320,72,1.0,70,1
None_149,token,1702.77666015625,1712.77666015625,71,0,368947791360.0,72,1,0,0,16320,73,1.0,71,1
None_149,token,1712.77666015625,1722.77666015625,72,0,373398996480.0,74,2,0,0,16320,75,1.0,72,2
None_149,token,1722.77666015625,1732.77666015625,74,0,374759523840.0,74,0,0,0,16320,75,1.0,74,0
None_149,token,1732.77666015625,1742.77666015625,73,0,373325596160.0,73,0,0,0,16320,74,1.0,73,0
None_149,token,1742.77666015625,1752.77666015625,72,0,373831534080.0,73,1,0,0,16320,74,1.0,72,1
None_149,token,1752.77666015625,1762.77666015625,73,0,378225067520.0,74,1,0,0,16320,75,1.0,73,1
None_149,token,1762.77666015625,1792.77666015625,74,0,380364162560.0,75,1,0,0,16320,76,3.0,74,1
None_149,token,1792.77666015625,1802.77666015625,75,0,381593617920.0,76,1,0,0,16320,77,1.0,75,1
None_149,token,1802.77666015625,1812.77666015625,76,0,382293542400.0,77,1,0,0,16320,78,1.0,76,1
None_149,token,1812.77666015625,1822.77666015625,77,0,385806272000.0,78,1,0,0,16320,79,1.0,77,1
None_149,token,1822.77666015625,1842.77666015625,77,0,390359713280.0,78,1,0,0,16320,79,2.0,77,1
None_149,token,1842.77666015625,1872.77666015625,77,0,395911923200.0,78,1,0,0,16320,79,3.0,77,1
None_149,token,1872.77666015625,1902.77666015625,76,0,403403998720.0,77,1,0,0,16320,78,3.0,76,1
None_149,token,1902.77666015625,1962.77666015625,77,0,403503613440.0,77,0,0,0,16320,78,6.0,77,0
None_149,token,1962.7766601562498,1992.7766601562498,75,0,402457658880.0,76,1,0,0,16320,77,3.0,75,1
None_149,token,1992.7766601562498,2042.7766601562498,76,0,404056737280.0,77,1,0,0,16320,78,5.0,76,1
None_149,token,2042.7766601562498,2052.77666015625,77,0,404630832640.0,77,0,0,0,16320,78,1.0,77,0
None_149,token,2052.77666015625,2062.77666015625,76,0,413902865920.0,79,3,0,0,16320,80,1.0,76,3
None_149,token,2062.77666015625,2102.77666015625,79,0,415113971200.0,79,0,0,0,16320,80,4.0,79,0
None_149,token,2102.77666015625,2112.77666015625,78,0,414125688320.0,78,0,0,0,16320,79,1.0,78,0
None_149,token,2112.77666015625,2122.77666015625,77,0,415512430080.0,78,1,0,0,16320,79,1.0,77,1
None_149,token,2122.77666015625,2152.77666015625,78,0,417135101440.0,78,0,0,0,16320,79,3.0,78,0
None_149,token,2152.77666015625,2162.77666015625,77,0,418262320640.0,78,1,0,0,16320,79,1.0,77,1
None_149,token,2162.77666015625,2192.77666015625,78,0,430237058560.0,79,1,0,0,16320,80,3.0,78,1
None_149,token,2192.77666015625,2202.77666015625,79,0,430417937920.0,79,0,0,0,16320,80,1.0,79,0
None_149,token,2202.77666015625,2232.77666015625,78,0,429115082240.0,78,0,0,0,16320,79,3.0,78,0
None_149,token,2232.77666015625,2242.77666015625,76,0,427586782720.0,77,1,0,0,16320,78,1.0,76,1
None_149,token,2242.77666015625,2252.77666015625,77,0,430588331520.0,78,1,0,0,16320,79,1.0,77,1
None_149,token,2252.77666015625,2262.77666015625,78,0,434727585280.0,79,1,0,0,16320,80,1.0,78,1
None_149,token,2262.77666015625,2272.77666015625,79,0,434863900160.0,79,0,0,0,16320,80,1.0,79,0
None_149,token,2272.77666015625,2282.77666015625,78,0,436486571520.0,79,1,0,0,16320,80,1.0,78,1
None_149,token,2282.77666015625,2292.77666015625,78,0,445286745600.0,81,3,0,0,16320,82,1.0,78,3
None_149,token,2292.77666015625,2332.77666015625,80,0,447454676480.0,81,1,0,0,16320,82,4.0,80,1
None_149,token,2332.77666015625,2342.77666015625,81,0,448576652800.0,81,0,0,0,16320,82,1.0,81,0
None_149,token,2342.77666015625,2352.77666015625,80,0,450183595520.0,82,2,0,0,16320,83,1.0,80,2
None_149,token,2352.77666015625,2362.77666015625,81,0,452970186240.0,83,2,0,0,16320,84,1.0,81,2
None_149,token,2362.77666015625,2372.77666015625,83,0,457843443200.0,84,1,0,0,16320,85,1.0,83,1
None_149,token,2372.77666015625,2382.77666015625,84,0,458081994240.0,84,0,0,0,16320,85,1.0,84,0
None_149,token,2382.77666015625,2392.77666015625,83,0,458029565440.0,84,1,0,0,16320,85,1.0,83,1
None_149,token,2392.77666015625,2402.77666015625,84,0,462019397120.0,86,2,0,0,16320,87,1.0,84,2
None_149,token,2402.77666015625,2422.77666015625,86,0,466491573760.0,87,1,0,0,16320,88,2.0,86,1
None_149,token,2422.77666015625,2442.77666015625,87,0,467527042560.0,87,0,0,0,16320,88,2.0,87,0
None_149,token,2442.77666015625,2452.77666015625,86,0,477535700480.0,87,1,0,0,16320,88,1.0,86,1
None_149,token,2452.77666015625,2462.77666015625,87,0,477622208000.0,87,0,0,0,16320,88,1.0,87,0
None_149,token,2462.77666015625,2482.77666015625,85,0,479504401920.0,86,1,0,0,16320,87,2.0,85,1
None_149,token,2482.77666015625,2492.77666015625,86,0,479708874240.0,86,0,0,0,16320,87,1.0,86,0
None_149,token,2492.77666015625,2502.77666015625,85,0,482697315840.0,86,1,0,0,16320,87,1.0,85,1
None_149,token,2502.77666015625,2522.77666015625,86,0,485790615040.0,87,1,0,0,16320,88,2.0,86,1
None_149,token,2522.77666015625,2532.77666015625,87,0,486860162560.0,87,0,0,0,16320,88,1.0,87,0
None_149,token,2532.77666015625,2542.77666015625,86,0,487927088640.0,88,2,0,0,16320,89,1.0,86,2
None_149,token,2542.77666015625,2552.77666015625,88,0,491049223680.0,89,1,0,0,16320,90,1.0,88,1
None_149,token,2552.77666015625,2572.77666015625,89,0,495977530880.0,91,2,0,0,16320,92,2.0,89,2
None_149,token,2572.77666015625,2582.77666015625,91,0,497248929280.0,91,0,0,0,16320,92,1.0,91,0
None_149,token,2582.77666015625,2592.77666015625,90,0,504305845760.0,93,3,0,0,16320,94,1.0,90,3
None_149,token,2592.77666015625,2602.77666015625,93,0,505134220800.0,93,0,0,0,16320,94,1.0,93,0
None_149,token,2602.77666015625,2612.77666015625,92,0,504090887680.0,92,0,0,0,16320,93,1.0,92,0
None_149,token,2612.77666015625,2622.77666015625,91,0,512885818880.0,95,4,0,0,16320,96,1.0,91,4
None_149,token,2622.77666015625,2652.77666015625,95,0,514775877120.0,95,0,0,0,16320,96,3.0,95,0
None_149,token,2652.77666015625,2672.77666015625,94,0,514574026240.0,95,1,0,0,16320,96,2.0,94,1
None_149,token,2672.77666015625,2682.77666015625,95,0,525526402560.0,96,1,0,0,16320,97,1.0,95,1
None_149,token,2682.77666015625,2692.77666015625,96,0,525633881600.0,96,0,0,0,16320,97,1.0,96,0
None_149,token,2692.77666015625,2722.77666015625,95,0,525261637120.0,96,1,0,0,16320,97,3.0,95,1
None_149,token,2722.77666015625,2732.77666015625,96,0,528934274560.0,97,1,0,0,16320,98,1.0,96,1
None_149,token,2732.77666015625,2742.77666015625,97,0,530092951040.0,98,1,0,0,16320,99,1.0,97,1
None_149,token,2742.77666015625,2752.77666015625,98,0,532916241920.0,99,1,0,0,16320,100,1.0,98,1
None_149,token,2752.77666015625,2762.77666015625,99,0,534174533120.0,100,1,0,0,16320,101,1.0,99,1
None_149,token,2762.77666015625,2772.77666015625,100,0,535482631680.0,101,1,0,0,16320,102,1.0,100,1
None_149,token,2772.77666015625,2782.77666015625,101,0,547221440000.0,103,2,0,0,16320,104,1.0,101,2
None_149,token,2782.77666015625,2792.77666015625,101,0,544115033600.0,102,1,0,0,16320,103,1.0,101,1
None_149,token,2792.77666015625,2822.77666015625,102,0,554915366400.0,103,1,0,0,16320,104,3.0,102,1
None_149,token,2822.77666015625,2852.77666015625,103,0,554975659520.0,103,0,0,0,16320,104,3.0,103,0
None_149,token,2852.77666015625,2862.77666015625,101,0,556100257280.0,102,1,0,0,16320,103,1.0,101,1
None_149,token,2862.77666015625,2872.77666015625,102,0,557355927040.0,103,1,0,0,16320,104,1.0,102,1
None_149,token,2872.77666015625,2882.77666015625,103,0,563015616000.0,104,1,0,0,16320,105,1.0,103,1
None_149,token,2882.77666015625,2892.77666015625,103,0,565062960640.0,106,3,0,0,16320,107,1.0,103,3
None_149,token,2892.77666015625,2932.77666015625,106,0,576371852800.0,107,1,0,0,16320,108,4.0,106,1
None_149,token,2932.77666015625,2952.77666015625,107,0,576484574720.0,107,0,0,0,16320,108,2.0,107,0
None_149,token,2952.77666015625,2962.77666015625,105,0,565631813120.0,106,1,0,0,16320,107,1.0,105,1
None_149,token,2962.77666015625,2982.77666015625,106,0,566861268480.0,107,1,0,0,16320,108,2.0,106,1
None_149,token,2982.77666015625,3002.77666015625,107,0,567068362240.0,107,0,0,0,16320,108,2.0,107,0
None_149,token,3002.77666015625,3012.77666015625,106,0,567951787520.0,108,2,0,0,16320,109,1.0,106,2
None_149,token,3012.77666015625,3042.77666015625,108,0,569469601280.0,109,1,0,0,16320,110,3.0,108,1
None_149,token,3042.77666015625,3052.77666015625,109,0,569700288000.0,109,0,0,0,16320,110,1.0,109,0
None_149,token,3052.77666015625,3062.77666015625,108,0,564342064640.0,113,5,0,0,16320,114,1.0,108,5
None_149,token,3062.77666015625,3082.77666015625,113,0,566845539840.0,114,1,0,0,16320,115,2.0,113,1
None_149,token,3082.77666015625,3092.77666015625,113,0,566027650560.0,116,3,0,0,16320,117,1.0,113,3
None_149,token,3092.77666015625,3102.77666015625,114,0,565542684160.0,117,3,0,0,16320,118,1.0,114,3
None_149,token,3102.77666015625,3112.77666015625,117,0,566336980480.0,117,0,0,0,16320,118,1.0,117,0
None_149,token,3112.77666015625,3122.77666015625,116,0,572591736320.0,122,6,0,0,16320,123,1.0,116,6
None_149,token,3122.77666015625,3172.77666015625,121,0,572536686080.0,121,0,0,0,16320,122,5.0,121,0
None_149,token,3172.77666015625,3192.77666015625,120,0,568612390400.0,120,0,0,0,16320,121,2.0,120,0
None_149,token,3192.77666015625,3202.77666015625,119,0,565002667520.0,119,0,0,0,16320,120,1.0,119,0
None_149,token,3202.77666015625,3212.77666015625,117,0,558435960320.0,120,3,0,0,16320,121,1.0,117,3
None_149,token,3212.77666015625,3262.77666015625,119,0,560719234560.0,119,0,0,0,16320,120,5.0,119,0
None_149,token,3262.77666015625,3272.77666015625,117,0,556425315840.0,122,5,0,0,16320,123,1.0,117,5
None_149,token,3272.77666015625,3282.77666015625,121,0,559143749120.0,121,0,0,0,16320,122,1.0,121,0
None_149,token,3282.77666015625,3312.77666015625,120,0,554545743360.0,120,0,0,0,16320,121,3.0,120,0
None_149,token,3312.77666015625,3322.77666015625,119,0,552152368640.0,123,4,0,0,16320,124,1.0,119,4
None_149,token,3322.77666015625,3332.77666015625,120,0,549289756160.0,124,4,0,0,16320,125,1.0,120,4
None_149,token,3332.77666015625,3342.77666015625,123,0,553599403520.0,127,4,0,0,16320,128,1.0,123,4
None_149,token,3342.77666015625,3362.77666015625,127,0,554430400000.0,127,0,0,0,16320,128,2.0,127,0
None_149,token,3362.77666015625,3372.77666015625,126,0,549688215040.0,128,2,0,0,16320,129,1.0,126,2
None_149,token,3372.77666015625,3412.77666015625,128,0,551711966720.0,128,0,0,0,16320,129,4.0,128,0
None_149,token,3412.77666015625,3422.77666015625,127,0,550372410880.0,127,0,0,0,16320,128,1.0,127,0
None_149,token,3422.77666015625,3442.77666015625,126,0,549198005760.0,126,0,0,0,16320,127,2.0,126,0
None_149,token,3442.77666015625,3452.77666015625,125,0,545606632960.0,132,7,0,0,16320,133,1.0,125,7
None_149,token,3452.77666015625,3462.77666015625,132,0,551048742400.0,133,1,0,0,16320,134,1.0,132,1
None_149,token,3462.77666015625,3482.77666015625,133,0,552679278080.0,133,0,0,0,16320,134,2.0,133,0
None_149,token,3482.77666015625,3492.77666015625,131,0,552951907840.0,132,1,0,0,16320,133,1.0,131,1
None_149,token,3492.77666015625,3522.77666015625,130,0,553290073600.0,131,1,0,0,16320,132,3.0,130,1
None_149,token,3522.77666015625,3532.77666015625,129,0,550534940160.0,131,2,0,0,16320,132,1.0,129,2
None_149,token,3532.77666015625,3542.77666015625,131,0,553955919360.0,132,1,0,0,16320,133,1.0,131,1
None_149,token,3542.77666015625,3562.77666015625,132,0,556454151680.0,132,0,0,0,16320,133,2.0,132,0
None_149,token,3562.77666015625,3582.77666015625,131,0,556228707840.0,132,1,0,0,16320,133,2.0,131,1
None_149,token,3582.77666015625,3592.77666015625,132,0,559114913280.0,133,1,0,0,16320,134,1.0,132,1
None_149,token,3592.77666015625,3602.77666015625,133,0,560132032000.0,133,0,0,0,16320,134,1.0,133,0
None_149,token,3602.77666015625,3612.77666015625,130,0,555513054720.0,130,0,0,0,16320,131,1.0,130,0
None_149,token,3612.77666015625,3642.77666015625,129,0,554338649600.0,129,0,0,0,16320,130,3.0,129,0
None_149,token,3642.77666015625,3652.77666015625,128,0,553646589440.0,128,0,0,0,16320,129,1.0,128,0
None_149,token,3652.77666015625,3672.77666015625,127,0,552377812480.0,127,0,0,0,16320,128,2.0,127,0
None_149,token,3672.77666015625,3692.77666015625,126,0,548838868480.0,126,0,0,0,16320,127,2.0,126,0
None_149,token,3692.77666015625,3702.77666015625,125,0,547525527040.0,125,0,0,0,16320,126,1.0,125,0
None_149,token,3702.77666015625,3732.77666015625,124,0,546206942720.0,124,0,0,0,16320,125,3.0,124,0
None_149,token,3732.77666015625,3742.77666015625,123,0,542256432640.0,123,0,0,0,16320,124,1.0,123,0
None_149,token,3742.77666015625,3752.77666015625,122,0,540906391040.0,122,0,0,0,16320,123,1.0,122,0
None_149,token,3752.77666015625,3772.77666015625,121,0,535477388800.0,121,0,0,0,16320,122,2.0,121,0
None_149,token,3772.77666015625,3802.77666015625,120,0,534211233280.0,120,0,0,0,16320,121,3.0,120,0
None_149,token,3802.77666015625,3832.77666015625,119,0,533212464640.0,119,0,0,0,16320,120,3.0,119,0
None_149,token,3832.77666015625,3872.77666015625,118,0,521156462080.0,118,0,0,0,16320,119,4.0,118,0
None_149,token,3872.77666015625,3892.77666015625,117,0,520411973120.0,117,0,0,0,16320,118,2.0,117,0
None_149,token,3892.77666015625,3912.77666015625,114,0,517051287040.0,114,0,0,0,16320,115,2.0,114,0
None_149,token,3912.77666015625,3922.77666015625,113,0,515735324160.0,113,0,0,0,16320,114,1.0,113,0
None_149,token,3922.77666015625,3932.77666015625,111,0,513129612800.0,111,0,0,0,16320,112,1.0,111,0
None_149,token,3932.77666015625,3972.77666015625,108,0,500609615360.0,108,0,0,0,16320,109,4.0,108,0
None_149,token,3972.77666015625,3982.77666015625,107,0,494873904640.0,107,0,0,0,16320,108,1.0,107,0
None_149,token,3982.77666015625,3992.77666015625,105,0,492239357440.0,105,0,0,0,16320,106,1.0,105,0
None_149,token,3992.77666015625,4002.77666015625,104,0,490758243840.0,104,0,0,0,16320,105,1.0,104,0
None_149,token,4002.77666015625,4032.77666015625,103,0,484120757760.0,103,0,0,0,16320,104,3.0,103,0
None_149,token,4032.77666015625,4042.77666015625,102,0,477092677120.0,102,0,0,0,16320,103,1.0,102,0
None_149,token,4042.77666015625,4052.77666015625,101,0,475742635520.0,101,0,0,0,16320,102,1.0,101,0
None_149,token,4052.77666015625,4062.77666015625,100,0,474442401280.0,100,0,0,0,16320,101,1.0,100,0
None_149,token,4062.77666015625,4072.77666015625,99,0,471805232640.0,99,0,0,0,16320,100,1.0,99,0
None_149,token,4072.77666015625,4082.77666015625,98,0,470494512640.0,98,0,0,0,16320,99,1.0,98,0
None_149,token,4082.77666015625,4102.77666015625,97,0,469105149440.0,97,0,0,0,16320,98,2.0,97,0
None_149,token,4102.77666015625,4112.77666015625,96,0,467797050880.0,96,0,0,0,16320,97,1.0,96,0
None_149,token,4112.77666015625,4132.77666015625,95,0,464064120320.0,95,0,0,0,16874,96,2.0,95,0
None_149,token,4132.77666015625,4152.77666015625,94,0,462792721920.0,94,0,0,0,16874,95,2.0,94,0
None_149,token,4152.77666015625,4192.77666015625,92,0,458113451520.0,92,0,0,0,16874,93,4.0,92,0
None_149,token,4192.77666015625,4222.77666015625,91,0,457342748160.0,91,0,0,0,16874,92,3.0,91,0
None_149,token,4222.77666015625,4232.77666015625,90,0,453305730560.0,90,0,0,0,16874,91,1.0,90,0
None_149,token,4232.77666015625,4242.77666015625,89,0,452254533120.0,89,0,0,0,16874,90,1.0,89,0
None_149,token,4242.77666015625,4252.77666015625,88,0,451378972160.0,88,0,0,0,16874,89,1.0,88,0
None_149,token,4252.77666015625,4302.77666015625,86,0,449806108160.0,86,0,0,0,16874,87,5.0,86,0
None_149,token,4302.77666015625,4312.77666015625,85,0,448539952640.0,85,0,0,0,16874,86,1.0,85,0
None_149,token,4312.77666015625,4322.77666015625,83,0,434832442880.0,83,0,0,0,16874,84,1.0,83,0
None_149,token,4322.77666015625,4332.77666015625,82,0,430714160640.0,82,0,0,0,16874,83,1.0,82,0
None_149,token,4332.77666015625,4342.77666015625,81,0,426763650560.0,81,0,0,0,16874,82,1.0,81,0
None_149,token,4342.77666015625,4352.77666015625,79,0,422425167360.0,79,0,0,0,16874,80,1.0,79,0
None_149,token,4352.77666015625,4362.77666015625,77,0,420356851200.0,77,0,0,0,16874,78,1.0,77,0
None_149,token,4362.77666015625,4412.77666015625,75,0,415273879040.0,75,0,0,0,16874,76,5.0,75,0
None_149,token,4412.77666015625,4472.77666015625,74,0,413989373440.0,74,0,0,0,16874,75,6.0,74,0
None_149,token,4472.77666015625,4512.77666015625,73,0,412655060480.0,73,0,0,0,16874,74,4.0,73,0
None_149,token,4512.77666015625,4532.77666015625,72,0,408777950720.0,72,0,0,0,16874,73,2.0,72,0
None_149,token,4532.77666015625,4542.77666015625,71,0,407409559040.0,71,0,0,0,16874,72,1.0,71,0
None_149,token,4542.77666015625,4592.77666015625,70,0,403569149440.0,70,0,0,0,16874,71,5.0,70,0
None_149,token,4592.77666015625,4612.77666015625,69,0,402675238400.0,69,0,0,0,16874,70,2.0,69,0
None_149,token,4612.77666015625,4662.77666015625,68,0,397020792320.0,68,0,0,0,16874,69,5.0,68,0
None_149,token,4662.77666015625,4682.77666015625,67,0,393125332480.0,67,0,0,0,16874,68,2.0,67,0
None_149,token,4682.77666015625,4702.77666015625,66,0,389395023360.0,66,0,0,0,16874,67,2.0,66,0
None_149,token,4702.77666015625,4722.77666015625,65,0,385483834880.0,65,0,0,0,16874,66,2.0,65,0
None_149,token,4722.77666015625,4752.77666015625,64,0,381929162240.0,64,0,0,0,16874,65,3.0,64,0
None_149,token,4752.77666015625,4862.77666015625,63,0,377685050880.0,63,0,0,0,16874,64,11.0,63,0
None_149,token,4862.77666015625,4882.77666015625,62,0,373553661440.0,62,0,0,0,16874,63,2.0,62,0
None_149,token,4882.77666015625,4942.77666015625,61,0,369713251840.0,61,0,0,0,16874,62,6.0,61,0
None_149,token,4942.77666015625,4962.77666015625,60,0,368740697600.0,60,0,0,0,16874,61,2.0,60,0
None_149,token,4962.77666015625,4982.77666015625,59,0,364821644800.0,59,0,0,0,16874,60,2.0,59,0
None_149,token,4982.77666015625,5022.77666015625,58,0,363280238080.0,58,0,0,0,16874,59,4.0,58,0
None_149,token,5022.77666015625,5102.77666015625,57,0,359313999360.0,57,0,0,0,16874,58,8.0,57,0
None_149,token,5102.77666015625,5112.77666015625,56,0,355130181120.0,56,0,0,0,16874,57,1.0,56,0
None_149,token,5112.77666015625,5132.77666015625,55,0,350914905600.0,55,0,0,0,16874,56,2.0,55,0
None_149,token,5132.77666015625,5152.77666015625,54,0,347008960000.0,54,0,0,0,16874,55,2.0,54,0
None_149,token,5152.77666015625,5242.77666015625,53,0,345997084160.0,53,0,0,0,16874,54,9.0,53,0
None_149,token,5242.77666015625,5282.77666015625,51,0,338410636800.0,51,0,0,0,16874,52,4.0,51,0
None_149,token,5282.77666015625,5292.77666015625,50,0,334761592320.0,50,0,0,0,16874,51,1.0,50,0
None_149,token,5292.77666015625,5332.77666015625,48,0,326734743040.0,48,0,0,0,16874,49,4.0,48,0
None_149,token,5332.77666015625,5352.77666015625,46,0,319064409600.0,46,0,0,0,16874,47,2.0,46,0
None_149,token,5352.77666015625,5382.77666015625,45,0,315163706880.0,45,0,0,0,16874,46,3.0,45,0
None_149,token,5382.77666015625,5402.77666015625,44,0,311299704320.0,44,0,0,0,16874,45,2.0,44,0
None_149,token,5402.77666015625,5432.77666015625,43,0,307516966400.0,43,0,0,0,16874,44,3.0,43,0
None_149,token,5432.77666015625,5442.77666015625,41,0,302174471680.0,41,0,0,0,16874,42,1.0,41,0
None_149,token,5442.77666015625,5452.77666015625,40,0,298244933120.0,40,0,0,0,16874,41,1.0,40,0
None_149,token,5452.77666015625,5472.77666015625,39,0,294032279040.0,39,0,0,0,16874,40,2.0,39,0
None_149,token,5472.77666015625,5492.77666015625,37,0,285976593920.0,37,0,0,0,16874,38,2.0,37,0
None_149,token,5492.77666015625,5602.77666015625,36,0,281963169280.0,36,0,0,0,16874,37,11.0,36,0
None_149,token,5602.77666015625,5632.77666015625,35,0,278177809920.0,35,0,0,0,16874,36,3.0,35,0
None_149,token,5632.77666015625,5672.77666015625,34,0,273606018560.0,34,0,0,0,16874,35,4.0,34,0
None_149,token,5672.77666015625,5942.77666015625,32,0,265665676800.0,32,0,0,0,16874,33,27.0,32,0
None_149,token,5942.77666015625,6012.77666015625,31,0,261639144960.0,31,0,0,0,16874,32,7.0,31,0
None_149,token,6012.77666015625,6132.77666015625,30,0,257599505920.0,30,0,0,0,16874,31,12.0,30,0
None_149,token,6132.77666015625,6192.77666015625,29,0,253863953920.0,29,0,0,0,16874,30,6.0,29,0
None_149,token,6192.77666015625,6272.77666015625,28,0,249889850880.0,28,0,0,0,16874,29,8.0,28,0
None_149,token,6272.77666015625,6352.77666015625,27,0,245871183360.0,27,0,0,0,16874,28,8.0,27,0
None_149,token,6352.77666015625,6372.77666015625,26,0,241674257920.0,26,0,0,0,16874,27,2.0,26,0
None_149,token,6372.77666015625,6382.77666015625,25,0,237642483200.0,25,0,0,0,16874,26,1.0,25,0
None_149,token,6382.77666015625,6432.77666015625,24,0,233707701760.0,24,0,0,0,16874,25,5.0,24,0
None_149,token,6432.77666015625,6442.77666015625,23,0,229214553600.0,23,0,0,0,16874,24,1.0,23,0
None_149,token,6442.77666015625,6472.77666015625,22,0,225518323200.0,22,0,0,0,16874,23,3.0,22,0
None_149,token,6472.77666015625,6512.77666015625,21,0,221085468160.0,21,0,0,0,3893,22,4.0,21,0
None_149,token,6512.77666015625,6552.77666015625,20,0,217205736960.0,20,0,0,0,3893,21,4.0,20,0
None_149,token,6552.77666015625,6572.77666015625,19,0,213496399360.0,19,0,0,0,3893,20,2.0,19,0
None_149,token,6572.77666015625,6602.77666015625,18,0,209781818880.0,18,0,0,0,3893,19,3.0,18,0
None_149,token,6602.77666015625,6612.77666015625,17,0,205773637120.0,17,0,0,0,3893,18,1.0,17,0
None_149,token,6612.77666015625,6992.77666015625,16,0,201907013120.0,16,0,0,0,3893,17,38.0,16,0
None_149,token,6992.77666015625,7142.77666015625,15,0,197628823040.0,15,0,0,0,3893,16,15.0,15,0
None_149,token,7142.77666015625,7152.77666015625,14,0,193536755200.0,14,0,0,0,3893,15,1.0,14,0
None_149,token,7152.77666015625,7292.77666015625,12,0,185840207360.0,12,0,0,0,3893,13,14.0,12,0
None_149,token,7292.77666015625,7302.77666015625,11,0,182107276800.0,11,0,0,0,3893,12,1.0,11,0
None_149,token,7302.77666015625,7342.77666015625,10,0,178017830400.0,10,0,0,0,3893,11,4.0,10,0
None_149,token,7342.77666015625,7472.77666015625,9,0,174274414080.0,9,0,0,0,3893,10,13.0,9,0
None_149,token,7472.77666015625,7732.77666015625,8,0,170575562240.0,8,0,0,0,3893,9,26.0,8,0
None_149,token,7732.77666015625,7782.77666015625,7,0,166467765760.0,7,0,0,0,3893,8,5.0,7,0
None_149,token,7782.776660156251,8312.77666015625,6,0,162299676160.0,6,0,0,0,5800,7,53.0,6,0
None_149,token,8312.77666015625,8322.77666015625,5,0,158008378880.0,5,0,0,0,7198,6,1.0,5,0
None_149,token,8322.77666015625,8542.77666015625,4,0,153310758400.0,4,0,0,0,14261,5,22.0,4,0
None_149,token,8542.77666015625,9582.77666015625,3,0,149174126080.0,3,0,0,0,14261,4,104.0,3,0
None_149,token,9582.77666015625,9682.77666015625,2,0,144880207360.0,2,0,0,0,14815,3,10.0,2,0
None_149,token,9682.77666015625,13072.77666015625,1,0,140426380800.0,1,0,0,0,15222,2,339.0,1,0
